+---+---+---+---+---+
|                   |
+   +---+   +---+   +
|       |   |   |   |
+   +---+---+   +   +
|           |   |   |
+---+---+---+   +   +
|                   |
+   +---+---+---+   +
|   |               |
+---+---+---+---+---+