+---+---+---+
|           |
+   +---+   +
|       |   |
+---+---+   +
|           |
+---+---+---+